{
    "groundTextureUrl": "./textures/ground4.jpg",
    "wallTextureUrl": "./textures/wall4.jpg",
    "size": { "width": 22, "height": 10 },
    "map": [
        [3, 2, 3, 2, 2, 2, 3, 2, 2, 2, 2, 2, 2, 2, 3, 2, 2, 2, 3, 2, 2, 2, 1],            
        [1, 0, 1, 0, 0, 0, 1, 0, 0, 0, 0, 0, 0, 0, 1, 0, 0, 0, 1, 0, 0, 0, 1],            
        [1, 0, 1, 0, 0, 0, 1, 0, 3, 2, 2, 2, 1, 0, 1, 0, 0, 0, 1, 0, 0, 0, 1],            
        [1, 0, 1, 0, 0, 0, 1, 0, 1, 0, 0, 0, 5, 0, 1, 0, 0, 0, 1, 0, 0, 0, 1],            
        [2, 2, 1, 0, 0, 0, 1, 0, 1, 0, 0, 0, 1, 0, 1, 0, 0, 0, 3, 4, 2, 2, 1],            
        [0, 0, 1, 0, 0, 0, 1, 0, 1, 0, 0, 0, 1, 0, 1, 0, 0, 0, 1, 0, 0, 0, 1],            
        [1, 0, 1, 0, 0, 0, 5, 0, 1, 0, 0, 0, 1, 0, 1, 0, 0, 0, 5, 0, 0, 0, 1],            
        [1, 0, 1, 0, 0, 0, 1, 0, 1, 0, 0, 0, 1, 0, 1, 0, 0, 0, 1, 0, 0, 0, 6],            
        [1, 0, 2, 2, 2, 2, 0, 0, 1, 0, 0, 0, 1, 0, 2, 2, 2, 2, 0, 0, 0, 0, 1],            
        [1, 0, 0, 0, 0, 0, 0, 0, 1, 0, 0, 0, 1, 0, 0, 0, 0, 0, 0, 0, 0, 0, 0],            
        [2, 2, 2, 2, 2, 2, 2, 2, 2, 2, 2, 2, 2, 2, 2, 2, 2, 2, 2, 2, 2, 2, 0]
    ],

    "initialPosition": [9,20],
    "initialDirection": 0.0,
    "exitLocation": [-0.5, 6],

    "salaB202DoorLocation": [3, 12],
    "salaB203DoorLocation": [6, 6],
    "salaB205DoorLocation": [6, 18],
    "salaB207DoorLocation": [4, 19],

    "elevatorDoorLocation": [6, 19],

    "accessToBuildingC": [8,21],
    "accessToBuildingD": [9,20]
}