{
    "building": ["B", 3],
    "groundTextureUrl": "./textures/ground4.jpg",
    "wallTextureUrl": "./textures/wall4.jpg",

    "size": { "width": 22, "height": 10 },
    "map": [
        [3, 2, 2, 2, 3, 2, 2, 2, 2, 2, 2, 3, 2, 2, 2, 2, 2, 2, 3, 2, 2, 2, 1],
        [1, 0, 0, 0, 1, 0, 0, 0, 0, 0, 0, 1, 0, 0, 0, 0, 0, 0, 1, 0, 0, 0, 1],
        [1, 0, 0, 0, 1, 0, 0, 0, 0, 0, 0, 1, 0, 0, 0, 0, 0, 0, 1, 0, 0, 0, 1],
        [1, 0, 0, 0, 1, 0, 0, 0, 0, 0, 0, 1, 0, 0, 0, 0, 0, 0, 1, 0, 0, 0, 1],
        [3, 2, 4, 2, 2, 2, 4, 2, 2, 2, 2, 2, 4, 2, 2, 2, 2, 2, 2, 4, 2, 2, 1],
        [1, 0, 0, 0, 0, 0, 0, 0, 0, 0, 0, 0, 0, 0, 0, 0, 0, 0, 0, 0, 0, 0, 1],
        [3, 2, 4, 2, 1, 0, 3, 2, 2, 2, 3, 2, 2, 2, 2, 4, 2, 2, 1, 0, 2, 2, 1],
        [1, 0, 0, 0, 1, 0, 1, 0, 0, 0, 1, 0, 0, 0, 0, 0, 0, 0, 1, 0, 7, 0, 1],
        [1, 0, 0, 0, 1, 0, 5, 0, 0, 0, 1, 0, 0, 0, 0, 0, 0, 0, 3, 4, 2, 2, 1],
        [1, 0, 0, 0, 1, 0, 1, 0, 0, 0, 1, 0, 0, 0, 0, 0, 0, 0, 1, 0, 0, 0, 1],
        [2, 2, 2, 2, 2, 2, 2, 2, 2, 2, 2, 2, 2, 2, 2, 2, 2, 2, 2, 2, 2, 2, 0]

    ],
    "initialPosition": [6, 21],
    "initialDirection": 0.0,
    "exitLocation": [-0.5, 6],

    "elevatorDoorLocation": [6, 21],
    "elevatorDirection": -190.08
}
