{
    "building": ["B", 3],
    "groundTextureUrl": "./textures/ground4.jpg",
    "wallTextureUrl": "./textures/wall4.jpg",
    "doorTextureUrl": "./textures/door_2.png",
    "size": { "width": 22, "height": 12 },
    "map": [
        [0, 0, 0, 0, 0, 0, 0, 0, 0, 0, 0, 0, 0, 0, 0, 0, 0, 0, 0, 0, 0, 0, 0],
        [3, 2, 3, 2, 2, 2, 3, 2, 2, 2, 2, 2, 2, 2, 3, 2, 2, 2, 3, 2, 2, 2, 1],
        [1, 0, 1, 0, 0, 0, 1, 0, 0, 0, 0, 0, 0, 0, 1, 0, 0, 0, 1, 0, 0, 0, 1],
        [1, 0, 1, 0, 0, 0, 1, 0, 3, 2, 2, 2, 1, 0, 1, 0, 0, 0, 1, 0, 0, 0, 1],
        [1, 0, 1, 0, 0, 0, 1, 0, 1, 0, 0, 0, 5, 0, 1, 0, 0, 0, 1, 0, 0, 0, 1],
        [2, 2, 1, 0, 0, 0, 1, 0, 1, 0, 0, 0, 1, 0, 1, 0, 0, 0, 3, 4, 2, 2, 1],
        [0, 0, 1, 0, 0, 0, 1, 0, 1, 0, 0, 0, 1, 0, 1, 0, 0, 0, 1, 0, 0, 0, 1],
        [1, 0, 1, 0, 0, 0, 5, 0, 1, 0, 0, 0, 1, 0, 1, 0, 0, 0, 5, 0, 2, 2, 1],
        [1, 0, 1, 0, 0, 0, 1, 0, 1, 0, 0, 0, 1, 0, 1, 0, 0, 0, 1, 0, 7, 0, 1],
        [1, 0, 2, 2, 2, 2, 0, 0, 1, 0, 0, 0, 1, 0, 2, 2, 2, 2, 0, 0, 2, 2, 0],
        [1, 0, 0, 0, 0, 0, 0, 0, 1, 0, 0, 0, 1, 0, 0, 0, 0, 0, 0, 0, 0, 0, 0],
        [2, 2, 2, 2, 2, 2, 2, 2, 2, 2, 2, 2, 2, 2, 2, 2, 2, 2, 2, 2, 0, 0, 0],
        [0, 0, 0, 0, 0, 0, 0, 0, 0, 0, 0, 0, 0, 0, 0, 0, 0, 0, 0, 0, 0, 0, 0]
    ],

    "initialPosition": [1,10],
    "initialDirection": 0.0,
    "exitLocation": [-0.5, 6],

    "elevatorDoorLocation": [7, 21],
    "elevator": [8, 20],
    "elevatorDirection": -190.08,

    "accessToBuilding": [["A",2,[5,-1],[6,-1],[5,22]],["C",3,[9,22],[10,22],[9,0]],["D",3,[11,20],[11,21],[1,9]]]

}
