{
    "groundTextureUrl": "./textures/ground4.jpg",
    "wallTextureUrl": "./textures/wall4.jpg",
    "size": { "width": 22, "height": 10 },
    "elevatorModelUrl": "",
    "doorModelUrl": "",
    "map": [
        [3, 2, 2, 2, 3, 2, 3, 2, 2, 2, 3, 2, 3, 2, 2, 2, 2, 2, 2, 2, 2, 2, 1],            
        [1, 0, 0, 0, 0, 0, 0, 0, 0, 0, 1, 0, 0, 0, 0, 0, 0, 0, 0, 0, 0, 0, 1],            
        [1, 0, 0, 0, 1, 0, 1, 0, 0, 0, 1, 0, 1, 0, 0, 0, 0, 0, 0, 0, 0, 0, 1],            
        [1, 0, 0, 0, 1, 0, 1, 0, 0, 0, 1, 0, 1, 0, 0, 0, 0, 0, 0, 0, 0, 0, 1],            
        [1, 0, 0, 0, 1, 0, 1, 0, 0, 0, 1, 0, 1, 0, 0, 0, 0, 0, 0, 0, 0, 0, 1],            
        [1, 0, 0, 0, 1, 0, 1, 0, 0, 0, 1, 0, 1, 0, 0, 0, 0, 0, 0, 0, 0, 0, 1],            
        [1, 0, 0, 0, 1, 0, 1, 0, 0, 0, 1, 0, 2, 2, 2, 2, 2, 2, 2, 2, 2, 2, 1],            
        [1, 0, 0, 0, 1, 0, 1, 0, 0, 0, 1, 0, 0, 0, 0, 0, 0, 0, 0, 0, 0, 0, 1],            
        [1, 0, 0, 0, 1, 0, 2, 2, 2, 2, 0, 0, 3, 0, 2, 2, 2, 2, 1, 0, 2, 2, 0],            
        [1, 0, 0, 0, 1, 0, 0, 0, 0, 0, 0, 0, 1, 0, 0, 0, 0, 0, 1, 0, 0, 0, 0],            
        [2, 2, 2, 2, 2, 2, 2, 2, 2, 2, 2, 2, 2, 2, 2, 2, 2, 2, 2, 2, 2, 2, 0]
    ],
    "initialPosition": [8,21], 
    "initialDirection": 0.0,
    "exitLocation": [-0.5, 6],

    "salaB301DoorLocation": [1, 4],
    "salaB302DoorLocation": [7, 13],
    "salaB303DoorLocation": [1, 5],
    "salaB305DoorLocation": [1, 11],

    "elevatorDoorLocation": [6, 19],

    "accessToBuildingC": [8,21]
}