{
    "groundTextureUrl": "./textures/ground4.jpg",
    "wallTextureUrl": "./textures/wall4.jpg",
    "size": { "width": 12, "height": 20 },
    "elevatorModelUrl": "",
    "doorModelUrl": "",
    "map": [
        [3, 2, 2, 2, 2, 2, 3, 2, 2, 2, 2, 2, 1],
        [1, 0, 0, 0, 0, 0, 1, 0, 0, 0, 0, 0, 1],
        [1, 0, 0, 0, 0, 0, 1, 0, 0, 0, 0, 0, 1],
        [1, 0, 0, 0, 0, 0, 1, 0, 0, 0, 0, 0, 1],
        [1, 0, 0, 0, 0, 0, 1, 0, 0, 0, 0, 0, 1],
        [1, 0, 0, 0, 0, 0, 1, 0, 0, 0, 0, 0, 1],
        [1, 0, 0, 0, 0, 0, 3, 2, 2, 2, 4, 2, 1],
        [1, 0, 0, 0, 0, 0, 5, 0, 0, 0, 0, 0, 1],
        [2, 2, 2, 2, 2, 2, 0, 0, 3, 2, 2, 2, 1],
        [0, 0, 0, 0, 0, 0, 0, 0, 1, 0, 0, 0, 1],
        [1, 0, 0, 0, 0, 0, 0, 0, 1, 0, 0, 0, 1],
        [1, 0, 0, 0, 0, 0, 0, 0, 1, 0, 0, 0, 1],
        [1, 0, 0, 0, 0, 0, 0, 0, 2, 2, 4, 2, 1],
        [7, 0, 0, 0, 0, 0, 0, 0, 0, 0, 0, 0, 1],
        [3, 2, 2, 2, 2, 4, 2, 2, 2, 2, 2, 2, 1],
        [1, 0, 0, 0, 0, 0, 0, 0, 0, 0, 0, 0, 1],
        [1, 0, 0, 0, 0, 0, 0, 0, 0, 0, 0, 0, 1],
        [1, 0, 0, 0, 0, 0, 0, 0, 0, 0, 0, 0, 1],
        [1, 0, 0, 0, 0, 0, 0, 0, 0, 0, 0, 0, 1],
        [1, 0, 0, 0, 0, 0, 0, 0, 0, 0, 0, 0, 1],
        [2, 2, 2, 2, 2, 2, 2, 2, 2, 2, 2, 2, 0]
        ],

        "initialPosition": [8,0], 
        "initialDirection": 0.0,
        "exitLocation": [-0.5, 6],
    
        "salaC101DoorLocation": [1, 4],
        "salaC102DoorLocation": [1, 4],
        "salaC103DoorLocation": [1, 4],
        "salaC104DoorLocation": [1, 4],
    
        "elevatorDoorLocation": [12, 2],
    
        "accessToBuildingB": [8,0]
}