{
    "building": ["D", 3],
    "groundTextureUrl": "./textures/ground4.jpg",
    "wallTextureUrl": "./textures/wall5.jpg",
    "size": { "width": 12, "height": 20 },
    "map": [
            [3, 2, 2, 2, 2, 2, 2, 2, 0, 0, 2, 2, 0],
            [1, 0, 7, 0, 0, 0, 0, 0, 0, 0, 0, 0, 0],
            [3, 2, 2, 2, 1, 0, 0, 0, 3, 2, 2, 2, 1],
            [1, 0, 0, 0, 1, 0, 0, 0, 1, 0, 0, 0, 1],
            [1, 0, 0, 0, 1, 0, 0, 0, 1, 0, 0, 0, 1],
            [1, 0, 0, 0, 1, 0, 0, 0, 1, 0, 0, 0, 1],
            [1, 0, 0, 0, 1, 0, 0, 0, 1, 0, 0, 0, 1],
            [1, 0, 0, 0, 5, 0, 0, 0, 5, 0, 0, 0, 1],
            [1, 0, 0, 0, 1, 0, 0, 0, 1, 0, 0, 0, 1],
            [3, 2, 2, 2, 1, 0, 0, 0, 3, 2, 2, 2, 1],
            [1, 0, 0, 0, 1, 0, 0, 0, 1, 0, 0, 0, 1],
            [1, 0, 0, 0, 5, 0, 0, 0, 5, 0, 0, 0, 1],
            [1, 0, 0, 0, 1, 0, 0, 0, 1, 0, 0, 0, 1],
            [1, 0, 0, 0, 1, 0, 0, 0, 1, 0, 0, 0, 1],
            [1, 0, 0, 0, 1, 0, 0, 0, 1, 0, 0, 0, 1],
            [1, 0, 0, 0, 1, 0, 0, 0, 1, 0, 0, 0, 1],
            [3, 2, 2, 2, 2, 4, 2, 2, 2, 2, 2, 2, 1],
            [1, 0, 0, 0, 0, 0, 0, 0, 0, 0, 0, 0, 1],
            [1, 0, 0, 0, 0, 0, 0, 0, 0, 0, 0, 0, 1],
            [1, 0, 0, 0, 0, 0, 0, 0, 0, 0, 0, 0, 1],
            [2, 2, 2, 2, 2, 2, 2, 2, 2, 2, 2, 2, 0]
        ],
        "initialPosition": [1,2],
        "initialDirection": 0.0,
        "exitLocation": [-0.5, 6],

        "elevatorDoorLocation": [0,1],
        "elevatorDirection": 190.08,

        "accessToBuilding": [["B",2,[-1,9],[-1,10]],["C",3,[0,12],[1,12]]]
}
