{
    "building": ["D", 3],
    "groundTextureUrl": "./textures/ground4.jpg",
    "wallTextureUrl": "./textures/wall5.jpg",
    "size": { "width": 12, "height": 22 },
    "map": [
            [0, 0, 0, 0, 0, 0, 0, 0, 0, 0, 0, 0, 0],
            [3, 2, 2, 2, 2, 2, 2, 2, 2, 2, 2, 2, 0],
            [1, 0, 7, 0, 0, 0, 0, 0, 0, 0, 0, 0, 0],
            [3, 2, 2, 2, 1, 0, 3, 2, 2, 2, 2, 2, 1],
            [1, 0, 0, 0, 5, 0, 1, 0, 0, 0, 0, 0, 1],
            [1, 0, 0, 0, 1, 0, 1, 0, 0, 0, 0, 0, 1],
            [1, 0, 0, 0, 1, 0, 1, 0, 0, 0, 0, 0, 1],
            [3, 2, 2, 2, 1, 0, 1, 0, 0, 0, 0, 0, 1],
            [1, 0, 0, 0, 1, 0, 1, 0, 0, 0, 0, 0, 1],
            [1, 0, 0, 0, 1, 0, 1, 0, 0, 0, 0, 0, 1],
            [1, 0, 0, 0, 1, 0, 1, 0, 0, 0, 0, 0, 1],
            [1, 0, 0, 0, 5, 0, 5, 0, 0, 0, 0, 0, 1],
            [1, 0, 0, 0, 1, 0, 1, 0, 0, 0, 0, 0, 1],
            [3, 2, 2, 2, 1, 0, 2, 2, 3, 2, 2, 2, 1],
            [1, 0, 0, 0, 1, 0, 0, 0, 1, 0, 0, 0, 1],
            [1, 0, 0, 0, 5, 0, 0, 0, 5, 0, 0, 0, 1],
            [1, 0, 0, 0, 1, 0, 0, 0, 1, 0, 0, 0, 1],
            [1, 0, 0, 0, 3, 4, 2, 2, 2, 2, 2, 2, 1],
            [1, 0, 0, 0, 1, 0, 0, 0, 0, 0, 0, 0, 1],
            [1, 0, 0, 0, 1, 0, 0, 0, 0, 0, 0, 0, 1],
            [1, 0, 0, 0, 1, 0, 0, 0, 0, 0, 0, 0, 1],
            [2, 2, 2, 2, 2, 2, 2, 2, 2, 2, 2, 2, 0],
            [0, 0, 0, 0, 0, 0, 0, 0, 0, 0, 0, 0, 0]
        ],

        "initialPosition": [14,5],
        "initialDirection": 0.0,
        "exitLocation": [-0.5, 6],

        "elevatorDoorLocation": [1,1],
        "elevator": [2, 1],
        "elevatorDirection": 190.08,

        "accessToBuilding": [["C",2,[1,12],[2,12],[15,0]]]

}
